NO assets/texture/
EA assets/texture/
WE assets/texture/
SO assets/texture/


C 211, 245, 255
F 193, 153, 62


11111111111111111111111111111
10000000000000000000000000001
10000000000000000000000000001
10000000110000000110000000001
10000000110000000110000000001
10000000000000000000000000001
100000000000S0000000000000001
10000000000000000000000000001
11111111111111111111111111111